####################
#****#********#****#
#*##*#*######*#*##*#
#*#**************#*#
#*#*##*##--##*##*#*#
#******#BRSO#******#
#*#*##*######*##*#*#
#*#**************#*#
#*##*#*######*#*##*#
#****#***P****#****#
####################