####################
#A***#********#***A#
#*##*#*######*#*##*#
#*#**************#*#
#*#*##*##--##*##*#*#
#******#BRSO#******#
#*#*##*######*##*#*#
#*#**************#*#
#*##*#*######*#*##*#
#A***#***P****#***A#
####################