####################
#A***#********#****#
#*##*#*######*#*##*#
#*#**************#*#
#*#*##*##--##*##*#*#
#******#BRSO#******#
#*#*##*######*##*#*#
#*#**************#*#
#*##*#*######*#*##*#
#****#***P****#***A#
####################