####################
#****#********#****#
#*##*#*######*#*##*#
#*#**************#*#
#*#*##*##""##*##*#*#
#******#""""#******#
#*#*##*######*##*#*#
#*#**************#*#
#*##*#*######*#*##*#
#****#***P****#****#
####################